PPPPPPPPPPPPPPPPPPPP
PP0P0PPPPPPPP000000P
000P0PP0000000PPPPPP
PP000PP0PPP0P0P0000P
P00P0PP0P0PPPPP0PP0P
PP0000P0P0P00000000P
P00PP000P0PPPPPPPP0P
P0PPPPP0P0P00000000P
P0P000P0P0P0PPP0PP0P
P0P0P0P000P0P000PP0P
P0P0P0P0P0P0P0P0PP0P
P0PPP0P0P0P0P0P0PP0P
P00000P0P000P0P0PP0P
PPPPPPPSPPPPPPPPPPPP
