PPPPPPPP0P
P0PPPPP00P
P00000P0PP
P0PPP0P0PP
P00000P00P
P0P0PPPP0P
P0P000000P
P0PPPPPPPP
P00000000S
PPPPPPPPPP
