PP0PPPPPPPPPPPP
PP0P0PP0P0P000P
P0000000P0PPP0P
PPPPP0P000P0P0S
P0000000P0P0P0P
P0PPPPPPP0P0P0P
P00000P000P0P0P
PPPPP0P0PPP0P0P
P000P0P00000P0P
P0P0P0PPPPP0P0P
P0P000P0000000P
PPPPPPPPPPPPPPP
